"filename", "language", "JavaScript", "comment", "blank", "total"
"/Users/francoismari/dev/adeno/app/assets/colors.js", "JavaScript", 3, 0, 1, 4
"/Users/francoismari/dev/adeno/app/assets/data/council.js", "JavaScript", 62, 0, 1, 63
"/Users/francoismari/dev/adeno/app/assets/data/files/competences/en.js", "JavaScript", 225, 0, 1, 226
"/Users/francoismari/dev/adeno/app/assets/data/files/competences/fr.js", "JavaScript", 225, 0, 76, 301
"/Users/francoismari/dev/adeno/app/assets/data/files/competences/getCompetences.js", "JavaScript", 12, 0, 4, 16
"/Users/francoismari/dev/adeno/app/assets/data/files/countries.js", "JavaScript", 33, 0, 3, 36
"/Users/francoismari/dev/adeno/app/assets/data/files/elections/en.js", "JavaScript", 29, 0, 2, 31
"/Users/francoismari/dev/adeno/app/assets/data/files/elections/fr.js", "JavaScript", 29, 0, 2, 31
"/Users/francoismari/dev/adeno/app/assets/data/files/elections/getElections.js", "JavaScript", 12, 0, 4, 16
"/Users/francoismari/dev/adeno/app/assets/data/files/enlargements/en.js", "JavaScript", 18, 0, 7, 25
"/Users/francoismari/dev/adeno/app/assets/data/files/enlargements/fr.js", "JavaScript", 17, 0, 7, 24
"/Users/francoismari/dev/adeno/app/assets/data/files/enlargements/getEnlargements.js", "JavaScript", 12, 0, 4, 16
"/Users/francoismari/dev/adeno/app/assets/data/files/figures.js", "JavaScript", 94, 0, 1, 95
"/Users/francoismari/dev/adeno/app/assets/data/files/figures/en.js", "JavaScript", 94, 0, 1, 95
"/Users/francoismari/dev/adeno/app/assets/data/files/figures/fr.js", "JavaScript", 94, 0, 1, 95
"/Users/francoismari/dev/adeno/app/assets/data/files/figures/getFigures.js", "JavaScript", 12, 0, 4, 16
"/Users/francoismari/dev/adeno/app/assets/data/files/filesThemes_en.js", "JavaScript", 48, 25, 1, 74
"/Users/francoismari/dev/adeno/app/assets/data/files/filesThemes_fr.js", "JavaScript", 49, 21, 1, 71
"/Users/francoismari/dev/adeno/app/assets/data/files/getFilesThemes.js", "JavaScript", 10, 0, 3, 13
"/Users/francoismari/dev/adeno/app/assets/data/files/groups/getGroups.js", "JavaScript", 50, 0, 5, 55
"/Users/francoismari/dev/adeno/app/assets/data/files/groups/groups_bg.js", "JavaScript", 86, 0, 1, 87
"/Users/francoismari/dev/adeno/app/assets/data/files/groups/groups_cs.js", "JavaScript", 86, 0, 1, 87
"/Users/francoismari/dev/adeno/app/assets/data/files/groups/groups_da.js", "JavaScript", 86, 0, 1, 87
"/Users/francoismari/dev/adeno/app/assets/data/files/groups/groups_de.js", "JavaScript", 87, 0, 1, 88
"/Users/francoismari/dev/adeno/app/assets/data/files/groups/groups_el.js", "JavaScript", 86, 0, 1, 87
"/Users/francoismari/dev/adeno/app/assets/data/files/groups/groups_en.js", "JavaScript", 86, 0, 1, 87
"/Users/francoismari/dev/adeno/app/assets/data/files/groups/groups_es.js", "JavaScript", 86, 0, 1, 87
"/Users/francoismari/dev/adeno/app/assets/data/files/groups/groups_et.js", "JavaScript", 86, 0, 1, 87
"/Users/francoismari/dev/adeno/app/assets/data/files/groups/groups_fi.js", "JavaScript", 86, 0, 1, 87
"/Users/francoismari/dev/adeno/app/assets/data/files/groups/groups_fr.js", "JavaScript", 86, 0, 1, 87
"/Users/francoismari/dev/adeno/app/assets/data/files/groups/groups_ga.js", "JavaScript", 86, 0, 1, 87
"/Users/francoismari/dev/adeno/app/assets/data/files/groups/groups_hr.js", "JavaScript", 86, 0, 1, 87
"/Users/francoismari/dev/adeno/app/assets/data/files/groups/groups_hu.js", "JavaScript", 86, 0, 1, 87
"/Users/francoismari/dev/adeno/app/assets/data/files/groups/groups_it.js", "JavaScript", 86, 0, 1, 87
"/Users/francoismari/dev/adeno/app/assets/data/files/groups/groups_lt.js", "JavaScript", 86, 0, 1, 87
"/Users/francoismari/dev/adeno/app/assets/data/files/groups/groups_lv.js", "JavaScript", 86, 0, 1, 87
"/Users/francoismari/dev/adeno/app/assets/data/files/groups/groups_mt.js", "JavaScript", 86, 0, 1, 87
"/Users/francoismari/dev/adeno/app/assets/data/files/groups/groups_nl.js", "JavaScript", 86, 0, 1, 87
"/Users/francoismari/dev/adeno/app/assets/data/files/groups/groups_pl.js", "JavaScript", 86, 0, 1, 87
"/Users/francoismari/dev/adeno/app/assets/data/files/groups/groups_pt.js", "JavaScript", 86, 0, 1, 87
"/Users/francoismari/dev/adeno/app/assets/data/files/groups/groups_ro.js", "JavaScript", 86, 0, 1, 87
"/Users/francoismari/dev/adeno/app/assets/data/files/groups/groups_sk.js", "JavaScript", 86, 0, 1, 87
"/Users/francoismari/dev/adeno/app/assets/data/files/groups/groups_sl.js", "JavaScript", 86, 0, 1, 87
"/Users/francoismari/dev/adeno/app/assets/data/files/history/en.js", "JavaScript", 0, 0, 1, 1
"/Users/francoismari/dev/adeno/app/assets/data/files/history/fr.js", "JavaScript", 0, 0, 1, 1
"/Users/francoismari/dev/adeno/app/assets/data/files/history/getHistory.js", "JavaScript", 12, 0, 4, 16
"/Users/francoismari/dev/adeno/app/assets/data/files/institutions/en.js", "JavaScript", 78, 0, 1, 79
"/Users/francoismari/dev/adeno/app/assets/data/files/institutions/fr.js", "JavaScript", 103, 0, 1, 104
"/Users/francoismari/dev/adeno/app/assets/data/files/institutions/getInstitutions.js", "JavaScript", 12, 0, 4, 16
"/Users/francoismari/dev/adeno/app/assets/data/files/principles/en.js", "JavaScript", 63, 0, 12, 75
"/Users/francoismari/dev/adeno/app/assets/data/files/principles/fr.js", "JavaScript", 63, 0, 12, 75
"/Users/francoismari/dev/adeno/app/assets/data/files/principles/getPrinciples.js", "JavaScript", 12, 0, 4, 16
"/Users/francoismari/dev/adeno/app/assets/data/files/symbols/en.js", "JavaScript", 37, 0, 13, 50
"/Users/francoismari/dev/adeno/app/assets/data/files/symbols/fr.js", "JavaScript", 37, 0, 13, 50
"/Users/francoismari/dev/adeno/app/assets/data/files/symbols/getSymbols.js", "JavaScript", 12, 0, 4, 16
"/Users/francoismari/dev/adeno/app/assets/data/files/treaties/en.js", "JavaScript", 103, 0, 67, 170
"/Users/francoismari/dev/adeno/app/assets/data/files/treaties/fr.js", "JavaScript", 129, 0, 83, 212
"/Users/francoismari/dev/adeno/app/assets/data/files/treaties/getTreaties.js", "JavaScript", 12, 0, 3, 15
"/Users/francoismari/dev/adeno/app/assets/data/multiplayer/getMultiplayerQuestions.js", "JavaScript", 7, 0, 2, 9
"/Users/francoismari/dev/adeno/app/assets/data/multiplayer/questions_en.js", "JavaScript", 452, 0, 1, 453
"/Users/francoismari/dev/adeno/app/assets/data/multiplayer/questions_fr.js", "JavaScript", 452, 7, 7, 466
"/Users/francoismari/dev/adeno/app/assets/data/partners.js", "JavaScript", 42, 0, 1, 43
"/Users/francoismari/dev/adeno/app/assets/data/solo/questionsByLocale.js", "JavaScript", 19, 1, 3, 23
"/Users/francoismari/dev/adeno/app/assets/data/solo/questions_bg.js", "JavaScript", 4646, 0, 1, 4647
"/Users/francoismari/dev/adeno/app/assets/data/solo/questions_cs.js", "JavaScript", 4627, 0, 1, 4628
"/Users/francoismari/dev/adeno/app/assets/data/solo/questions_da.js", "JavaScript", 4637, 0, 1, 4638
"/Users/francoismari/dev/adeno/app/assets/data/solo/questions_de.js", "JavaScript", 4650, 0, 1, 4651
"/Users/francoismari/dev/adeno/app/assets/data/solo/questions_dk.js", "JavaScript", 0, 0, 1, 1
"/Users/francoismari/dev/adeno/app/assets/data/solo/questions_el.js", "JavaScript", 4651, 0, 1, 4652
"/Users/francoismari/dev/adeno/app/assets/data/solo/questions_en.js", "JavaScript", 4636, 0, 1, 4637
"/Users/francoismari/dev/adeno/app/assets/data/solo/questions_es.js", "JavaScript", 4644, 0, 1, 4645
"/Users/francoismari/dev/adeno/app/assets/data/solo/questions_et.js", "JavaScript", 4626, 0, 1, 4627
"/Users/francoismari/dev/adeno/app/assets/data/solo/questions_fi.js", "JavaScript", 4637, 0, 1, 4638
"/Users/francoismari/dev/adeno/app/assets/data/solo/questions_fr.js", "JavaScript", 4645, 0, 1, 4646
"/Users/francoismari/dev/adeno/app/assets/data/solo/questions_ga.js", "JavaScript", 0, 0, 1, 1
"/Users/francoismari/dev/adeno/app/assets/data/solo/questions_hr.js", "JavaScript", 4628, 0, 1, 4629
"/Users/francoismari/dev/adeno/app/assets/data/solo/questions_hu.js", "JavaScript", 4644, 0, 0, 4644
"/Users/francoismari/dev/adeno/app/assets/data/solo/questions_it.js", "JavaScript", 4642, 0, 1, 4643
"/Users/francoismari/dev/adeno/app/assets/data/solo/questions_lt.js", "JavaScript", 4633, 0, 0, 4633
"/Users/francoismari/dev/adeno/app/assets/data/solo/questions_lv.js", "JavaScript", 4639, 0, 1, 4640
"/Users/francoismari/dev/adeno/app/assets/data/solo/questions_mt.js", "JavaScript", 4646, 0, 1, 4647
"/Users/francoismari/dev/adeno/app/assets/data/solo/questions_nl.js", "JavaScript", 0, 0, 1, 1
"/Users/francoismari/dev/adeno/app/assets/data/solo/questions_pl.js", "JavaScript", 4644, 0, 1, 4645
"/Users/francoismari/dev/adeno/app/assets/data/solo/questions_pt.js", "JavaScript", 4635, 0, 1, 4636
"/Users/francoismari/dev/adeno/app/assets/data/solo/questions_ro.js", "JavaScript", 4642, 0, 1, 4643
"/Users/francoismari/dev/adeno/app/assets/data/solo/questions_sk.js", "JavaScript", 4634, 0, 1, 4635
"/Users/francoismari/dev/adeno/app/assets/data/solo/questions_sl.js", "JavaScript", 4635, 0, 1, 4636
"/Users/francoismari/dev/adeno/app/assets/data/themes/getTheme.js", "JavaScript", 8, 21, 5, 34
"/Users/francoismari/dev/adeno/app/assets/data/themes/theme_cs.js", "JavaScript", 0, 0, 1, 1
"/Users/francoismari/dev/adeno/app/assets/data/themes/theme_de.js", "JavaScript", 0, 0, 1, 1
"/Users/francoismari/dev/adeno/app/assets/data/themes/theme_el.js", "JavaScript", 0, 0, 1, 1
"/Users/francoismari/dev/adeno/app/assets/data/themes/theme_fi.js", "JavaScript", 0, 0, 1, 1
"/Users/francoismari/dev/adeno/app/assets/data/themes/theme_ga.js", "JavaScript", 0, 0, 1, 1
"/Users/francoismari/dev/adeno/app/assets/data/themes/theme_hu.js", "JavaScript", 0, 0, 1, 1
"/Users/francoismari/dev/adeno/app/assets/data/themes/theme_it.js", "JavaScript", 0, 0, 1, 1
"/Users/francoismari/dev/adeno/app/assets/data/themes/theme_lv.js", "JavaScript", 0, 0, 1, 1
"/Users/francoismari/dev/adeno/app/assets/data/themes/themes_bg.js", "JavaScript", 0, 0, 1, 1
"/Users/francoismari/dev/adeno/app/assets/data/themes/themes_da.js", "JavaScript", 0, 0, 1, 1
"/Users/francoismari/dev/adeno/app/assets/data/themes/themes_en.js", "JavaScript", 79, 0, 1, 80
"/Users/francoismari/dev/adeno/app/assets/data/themes/themes_es.js", "JavaScript", 0, 0, 1, 1
"/Users/francoismari/dev/adeno/app/assets/data/themes/themes_et.js", "JavaScript", 0, 0, 1, 1
"/Users/francoismari/dev/adeno/app/assets/data/themes/themes_fr.js", "JavaScript", 79, 0, 1, 80
"/Users/francoismari/dev/adeno/app/assets/data/themes/themes_hr.js", "JavaScript", 0, 0, 1, 1
"/Users/francoismari/dev/adeno/app/assets/data/themes/themes_lt.js", "JavaScript", 0, 0, 1, 1
"/Users/francoismari/dev/adeno/app/assets/data/themes/themes_mt.js", "JavaScript", 0, 0, 1, 1
"/Users/francoismari/dev/adeno/app/assets/data/themes/themes_nl.js", "JavaScript", 0, 0, 1, 1
"/Users/francoismari/dev/adeno/app/assets/data/themes/themes_pl.js", "JavaScript", 0, 0, 1, 1
"/Users/francoismari/dev/adeno/app/assets/data/themes/themes_pt.js", "JavaScript", 0, 0, 1, 1
"/Users/francoismari/dev/adeno/app/assets/data/themes/themes_ro.js", "JavaScript", 0, 0, 1, 1
"/Users/francoismari/dev/adeno/app/assets/data/themes/themes_sk.js", "JavaScript", 0, 0, 1, 1
"/Users/francoismari/dev/adeno/app/assets/data/themes/themes_sl.js", "JavaScript", 0, 0, 1, 1
"/Users/francoismari/dev/adeno/app/assets/frMockCandidates.js", "JavaScript", 44, 0, 1, 45
"/Users/francoismari/dev/adeno/app/src/components/BackButton.js", "JavaScript", -28, -4, -3, -35
"/Users/francoismari/dev/adeno/app/src/components/BackgroundWrapper.js", "JavaScript", -44, -3, -7, -54
"/Users/francoismari/dev/adeno/app/src/components/CardWrapper.js", "JavaScript", -39, 0, -2, -41
"/Users/francoismari/dev/adeno/app/src/components/CenteredHeader.js", "JavaScript", -63, 0, -3, -66
"/Users/francoismari/dev/adeno/app/src/components/CenteredThemeHeader.js", "JavaScript", -67, 0, -3, -70
"/Users/francoismari/dev/adeno/app/src/components/CenteredTitleHeader.js", "JavaScript", -23, 0, -3, -26
"/Users/francoismari/dev/adeno/app/src/components/CloseButton.js", "JavaScript", -34, -1, -3, -38
"/Users/francoismari/dev/adeno/app/src/components/CustomText.js", "JavaScript", -19, -1, -5, -25
"/Users/francoismari/dev/adeno/app/src/components/MainHeader.js", "JavaScript", -90, -1, -5, -96
"/Users/francoismari/dev/adeno/app/src/components/Multiplayer/ChoicesButton.js", "JavaScript", -48, 0, -3, -51
"/Users/francoismari/dev/adeno/app/src/components/Multiplayer/MultiplayerResultCard.js", "JavaScript", -129, 0, -10, -139
"/Users/francoismari/dev/adeno/app/src/components/Multiplayer/ProgressBar.js", "JavaScript", -41, -1, -6, -48
"/Users/francoismari/dev/adeno/app/src/components/Multiplayer/ResultList.js", "JavaScript", -50, -2, -5, -57
"/Users/francoismari/dev/adeno/app/src/components/Multiplayer/ResultsFooter.js", "JavaScript", -58, -2, -2, -62
"/Users/francoismari/dev/adeno/app/src/components/Multiplayer/ResultsHeader.js", "JavaScript", -19, 0, -2, -21
"/Users/francoismari/dev/adeno/app/src/components/NextButton.js", "JavaScript", -75, -1, -11, -87
"/Users/francoismari/dev/adeno/app/src/components/Solo/QuestionHeader.js", "JavaScript", -74, -2, -2, -78
"/Users/francoismari/dev/adeno/app/src/context/userContext.js", "JavaScript", -31, 0, -6, -37
"/Users/francoismari/dev/adeno/app/src/languages/bg.js", "JavaScript", 0, 0, -1, -1
"/Users/francoismari/dev/adeno/app/src/languages/cs.js", "JavaScript", 0, 0, -1, -1
"/Users/francoismari/dev/adeno/app/src/languages/da.js", "JavaScript", 0, 0, -1, -1
"/Users/francoismari/dev/adeno/app/src/languages/de.js", "JavaScript", -163, 0, -1, -164
"/Users/francoismari/dev/adeno/app/src/languages/dk.js", "JavaScript", 0, 0, -1, -1
"/Users/francoismari/dev/adeno/app/src/languages/el.js", "JavaScript", 0, 0, -1, -1
"/Users/francoismari/dev/adeno/app/src/languages/en.js", "JavaScript", -245, 0, -1, -246
"/Users/francoismari/dev/adeno/app/src/languages/es.js", "JavaScript", -37, 0, -1, -38
"/Users/francoismari/dev/adeno/app/src/languages/et.js", "JavaScript", 0, 0, -1, -1
"/Users/francoismari/dev/adeno/app/src/languages/fi.js", "JavaScript", 0, 0, -1, -1
"/Users/francoismari/dev/adeno/app/src/languages/fr.js", "JavaScript", -246, 0, -1, -247
"/Users/francoismari/dev/adeno/app/src/languages/ga.js", "JavaScript", 0, 0, -1, -1
"/Users/francoismari/dev/adeno/app/src/languages/hr.js", "JavaScript", 0, 0, -1, -1
"/Users/francoismari/dev/adeno/app/src/languages/hu.js", "JavaScript", 0, 0, -1, -1
"/Users/francoismari/dev/adeno/app/src/languages/i18n.js", "JavaScript", -9, -1, -3, -13
"/Users/francoismari/dev/adeno/app/src/languages/it.js", "JavaScript", -37, 0, -1, -38
"/Users/francoismari/dev/adeno/app/src/languages/lt.js", "JavaScript", 0, 0, -1, -1
"/Users/francoismari/dev/adeno/app/src/languages/lv.js", "JavaScript", 0, 0, -1, -1
"/Users/francoismari/dev/adeno/app/src/languages/mt.js", "JavaScript", 0, 0, -1, -1
"/Users/francoismari/dev/adeno/app/src/languages/nl.js", "JavaScript", 0, 0, -1, -1
"/Users/francoismari/dev/adeno/app/src/languages/pl.js", "JavaScript", 0, 0, -1, -1
"/Users/francoismari/dev/adeno/app/src/languages/pt.js", "JavaScript", 0, 0, -1, -1
"/Users/francoismari/dev/adeno/app/src/languages/ro.js", "JavaScript", 0, 0, -1, -1
"/Users/francoismari/dev/adeno/app/src/languages/sk.js", "JavaScript", 0, 0, -1, -1
"/Users/francoismari/dev/adeno/app/src/languages/sl.js", "JavaScript", 0, 0, -1, -1
"/Users/francoismari/dev/adeno/app/src/navigation/StackNavigator.js", "JavaScript", -100, 0, -7, -107
"/Users/francoismari/dev/adeno/app/src/navigation/TabNavigator.js", "JavaScript", -89, 0, -9, -98
"/Users/francoismari/dev/adeno/app/src/screens/AllUserResults.js", "JavaScript", -10, 0, -2, -12
"/Users/francoismari/dev/adeno/app/src/screens/Discover/AllFiles.js", "JavaScript", -87, -1, -9, -97
"/Users/francoismari/dev/adeno/app/src/screens/Discover/File.js", "JavaScript", -24, 0, -5, -29
"/Users/francoismari/dev/adeno/app/src/screens/Discover/ThemeFiles.js", "JavaScript", -92, -1, -8, -101
"/Users/francoismari/dev/adeno/app/src/screens/Discover/index.js", "JavaScript", -331, 0, -23, -354
"/Users/francoismari/dev/adeno/app/src/screens/Home.js", "JavaScript", -363, -11, -30, -404
"/Users/francoismari/dev/adeno/app/src/screens/MultiplayerMode/MultiplayerQuestion.js", "JavaScript", -216, -10, -33, -259
"/Users/francoismari/dev/adeno/app/src/screens/MultiplayerMode/MultiplayerResults.js", "JavaScript", -125, -1, -19, -145
"/Users/francoismari/dev/adeno/app/src/screens/MultiplayerMode/MultiplePhones/Game.js", "JavaScript", -257, -19, -22, -298
"/Users/francoismari/dev/adeno/app/src/screens/MultiplayerMode/MultiplePhones/JoinGame.js", "JavaScript", -134, -7, -14, -155
"/Users/francoismari/dev/adeno/app/src/screens/MultiplayerMode/MultiplePhones/MultiplePhonesQuestions.js", "JavaScript", -287, -6, -22, -315
"/Users/francoismari/dev/adeno/app/src/screens/MultiplayerMode/MultiplePhones/MultiplePhonesResults.js", "JavaScript", -117, -1, -26, -144
"/Users/francoismari/dev/adeno/app/src/screens/MultiplayerMode/MultiplePhones/index.js", "JavaScript", -152, -23, -14, -189
"/Users/francoismari/dev/adeno/app/src/screens/MultiplayerMode/ResultExplaination.js", "JavaScript", 0, 0, -1, -1
"/Users/francoismari/dev/adeno/app/src/screens/MultiplayerMode/SelectMultiplayerMode.js", "JavaScript", -84, 0, -8, -92
"/Users/francoismari/dev/adeno/app/src/screens/MultiplayerMode/SetupMultiplayer.js", "JavaScript", -336, -3, -21, -360
"/Users/francoismari/dev/adeno/app/src/screens/Onboarding/Start.js", "JavaScript", -178, -4, -12, -194
"/Users/francoismari/dev/adeno/app/src/screens/Onboarding/Tutorial.js", "JavaScript", -113, 0, -3, -116
"/Users/francoismari/dev/adeno/app/src/screens/Onboarding/index.js", "JavaScript", -300, -8, -20, -328
"/Users/francoismari/dev/adeno/app/src/screens/Ranking/CountryResults.js", "JavaScript", -9, 0, -2, -11
"/Users/francoismari/dev/adeno/app/src/screens/Ranking/EuropeResults.js", "JavaScript", -9, 0, -2, -11
"/Users/francoismari/dev/adeno/app/src/screens/Ranking/index.js", "JavaScript", -252, -12, -14, -278
"/Users/francoismari/dev/adeno/app/src/screens/ScientificCouncil.js", "JavaScript", -31, 0, -4, -35
"/Users/francoismari/dev/adeno/app/src/screens/Settings.js", "JavaScript", -562, -6, -37, -605
"/Users/francoismari/dev/adeno/app/src/screens/SoloMode/ClassicMode.js", "JavaScript", -139, -2, -14, -155
"/Users/francoismari/dev/adeno/app/src/screens/SoloMode/ExpressMode.js", "JavaScript", -209, -2, -24, -235
"/Users/francoismari/dev/adeno/app/src/screens/SoloMode/ExpressResults.js", "JavaScript", -184, -7, -16, -207
"/Users/francoismari/dev/adeno/app/src/screens/SoloMode/QuestionContext.js", "JavaScript", -17, 0, -4, -21
"/Users/francoismari/dev/adeno/app/src/screens/SoloMode/RandomQuestionScreen.js", "JavaScript", -149, -5, -20, -174
"/Users/francoismari/dev/adeno/app/src/screens/SoloMode/SelectSoloMode.js", "JavaScript", -160, -3, -12, -175
"/Users/francoismari/dev/adeno/app/src/screens/SoloMode/SetStudyInfos.js", "JavaScript", -186, -3, -11, -200
"/Users/francoismari/dev/adeno/app/src/screens/SoloMode/ThemeQuestionScreen.js", "JavaScript", -154, -1, -19, -174
"/Users/francoismari/dev/adeno/app/src/screens/UserResults/GroupResultsDetails.js", "JavaScript", -162, -3, -15, -180
"/Users/francoismari/dev/adeno/app/src/screens/UserResults/ShareResults.js", "JavaScript", -9, 0, -2, -11
"/Users/francoismari/dev/adeno/app/src/screens/UserResults/index.js", "JavaScript", -347, -4, -19, -370
"/Users/francoismari/dev/adeno/app/src/utils/shuffleArray.js", "JavaScript", -13, -3, -4, -20
"Total", "-", 94727, -90, -195, 94442